01100000000000000000000000000000000000000000000000
00000000000000000000000000000000000000000000000000
00000000000000000000000000000000000000000000000000
00000000000000000000000000000000000000000000000000
00000010000000001111111111111111111111111111110000
00000010000000000000000000000000000000000000000000
00000010000000000000000000000000000000000000000000
00000010000000000000000000000001000000000000000000
00000010000000000000000000001001000000000000000000
00000010000000000000000000001001000000000000000000
00000010000000000000000000001001000000000000000000
00000010000000000000000000001001000000000000000000
00000010000000000000000000001001000000000000000000
00000010000000000000000000001001000000000000000000
00000010000000000000000000001001000000000000000000
00000010000000000000000000001001000000000000000000
00000010000000000000000000000001000000000000000000
00000011111111111111111111111001000000000000000000
00000000000000000000000000000001000000000000000000
00000011111111101111111111111111111111111111111100
00000010000000000000000000000001000000000000000000
00000010000000000000000000000001000000000000000000
00000010000000000000000000000001000000000000000000
00000010000000000000000000000001000000000000000000
00000010000000000000000000000001000000000000000000
00000010000000000000000000000001000000000000000000
00000010000000000000000000000001000000000000000000
00000010000000000000000000000001000000000000000000
00000010000000000000000000000001000000000000000000
00000010000000000000000000000001000000000000000000
00000010000000000000000000000001000000000000000000
00000010000000000000000000000001000000000000000000
00000010000000000000000000000001000000000000000000
00000010000000000000000000000000000000000000000000
00000000000000000000000000000000000000000000000000
00000000000000000000000000000000000000000000000000
00000000000000000000000000000000000000000000000000
00000000000001111111111111111111111111111111111100
00000000000000000000000000000000000000000000000000
00000000000000000000000000000000000000000000000000
00000000000000000000000000000000000000000000000000
00000000000000000000000000000000000000000000000000
00000000000000000000000000000000000000000000000000
00000000000000000000000000000000000000000000000000
00000000000000000000000000000000000000000000000000
00000000000000000000000000000000000000000000000000
00000000000000000000000000000000000000000000000000
00000000000000000000000000000000000000000000000000
00000000000000000000000000000000000000000000000000
00000000000000000000000000000000000000000000000000