11111111111111111111111111111111111111111111111111
10000000000000000000000000000000000000000000000001
10000000000000000000000000000000000000000000000001
10000000000000000000000000000000000000000000000001
11111111111111111111111111111111111000000000000001
10010010000000100000000000000111111111100000000001
10010010000000100000000000000000000000000000000001
10010010000000100000000111111111000000000001000001
10010010000000100000000000000000000000000001000001
10010010000000100000000000000000000000000001000001
10010010000000100000000000000000000000000001000001
10010010000000100000000000000000000000000001000001
10010010000000100000000000000000000000000001000001
10010010000000100000000000000000000001111111111111
10010010000000100000000000000000000000000000000001
10010010000000100000000000000000000000000000000001
10010010000000100000000000000000000000000000000001
10010010000000100000000000000000010000000000000001
10010010000000100000000000000000010000000000000001
10010010000000100000000110111100010000000000000001
10010010000000100000000100000000010000000000000001
10010010000000100000000100001000010000000000000001
10010010000000100000000100001000010000000000000001
10010010000000100000000100001000010000000000000001
10010010000000100000000100001000010000000000000001
10000010000000001111111100001000110000000000000001
10000010000000000000000100001000010000000000000001
10000010000000000000000100001000010000000000000001
10000010000000000000000111100000010000000000000001
10000010000000000000000000000000010000000000000001
10000010011111111111111111111111110000000000000001
10000000000000000000000000000000010000000000000001
10000000000000000000000000000000010000000000000001
10000000000000000000000000000000010000000000000001
10000111111111111111111111110000010000000000000001
10000000000000000000000000000000010000000000000001
10000000010000000001000000000000010000000000000001
10000000010000000001000000000000010000000000000001
10000000010000000001000000000000010000000000000001
10000000010000000001000000000000000000000000000001
10000000010000000001000000000000000000000000000001
10000000010000000001000000000000000000000000000001
10000000010000000001000000000000000000000000000001
10000000010000000001000000000000000000000000000001
10000000010000000001000000000000000000000000000001
10000000010000000001000001111111111111111111000001
10000000000000000001000000000000000000000000000001
10000000000000000001000000000000000000000000000001
10000000000000000001000000000000000000000000000001
11111111111111111111111111111111111111111111111111